
b	b	b	b	x	x	b	b	b	b
b	b	b	b	x	x	b	b	b	b
b	b	b	b	x	x	b	b	b	b
b	b	b	b	x	x	b	b	b	b
b	b	b	x	x	x	x	b	b	b
b	b	b	x	x	x	x	b	b	b
b	b	b	x	x	x	x	b	b	b
b	b	b	x	x	x	x	b	b	b
b	x	x	x	x	x	x	x	b	b
b	x	x	x	x	x	x	x	b	b
b	x	x	x	x	x	x	x	b	b
b	x	x	x	x	x	x	x	b	b
b	x	x	x	x	x	x	x	b	b
b	b	b	b	b	b	b	b	b	b
b	b	b	b	b	b	b	b	b	b
b	b	b	b	b	b	b	b	b	b
b	b	b	b	b	b	b	b	b	b
x	x	x	x	x	b	x	x	x	x
x	x	x	x	x	b	x	x	x	x
x	x	x	x	x	b	x	x	x	x
x	x	x	x	x	b	x	x	x	x
x	x	x	x	x	b	x	x	x	x
x	x	x	x	x	b	x	x	x	x
x	x	x	x	x	b	x	x	x	x
x	x	x	x	x	b	x	x	x	x
x	x	x	x	x	b	x	x	x	x
b	b	b	b	b	b	b	b	b	b
b	b	b	b	b	b	b	b	b	b
b	b	b	b	b	b	b	b	b	b
b	b	b	b	b	b	b	b	b	b
b	b	b	b	b	b	b	b	b	b
x	x	x	x	x	x	x	x	x	x
x	x	x	x	x	x	x	x	x	x
x	x	x	x	x	x	x	x	x	x
x	x	x	x	x	x	x	x	x	x
x	x	x	x	x	x	x	x	x	x
x	x	x	x	x	x	x	x	x	x
x	x	x	x	x	x	x	x	x	x
x	x	x	x	x	x	x	x	x	x
x	x	x	x	x	x	x	x	x	x
x	x	x	x	x	x	x	x	x	x
x	x	x	x	x	x	x	x	x	x
x	x	x	x	x	x	x	x	x	x
x	x	x	x	x	x	x	x	x	x
x	x	x	x	x	x	x	x	x	x
x	x	x	x	x	x	x	x	x	x
x	x	x	x	x	x	x	x	x	x
x	x	x	x	x	x	x	x	x	x
x	x	x	x	x	x	x	x	x	x
x	x	x	x	x	x	x	x	x	x
b	x	x	b	x	x	b	x	x	b
b	x	x	b	x	x	b	x	x	b
b	x	x	b	x	x	b	x	x	b
b	x	x	b	x	x	b	x	x	b
b	x	x	b	x	x	b	x	x	b
b	x	x	b	x	x	b	x	x	b
b	x	x	b	x	x	b	x	x	b
b	x	x	b	x	x	b	x	x	b
b	b	b	b	b	b	b	b	b	b
b	b	b	b	b	b	b	b	b	b
b	b	b	b	b	b	b	b	b	b
b	b	b	b	b	b	b	b	b	b
b	b	b	b	b	b	b	b	b	b
x	x	x	x	x	x	x	x	x	x
x	x	x	x	x	x	x	x	x	x
x	x	x	x	x	x	x	x	x	x
x	x	x	x	x	x	x	x	x	x
x	x	x	x	x	x	x	x	x	x
x	x	x	x	x	x	x	x	x	x
x	x	x	x	x	x	x	x	x	x
x	x	x	x	x	x	x	x	x	x
x	x	x	x	x	x	x	x	x	x
x	x	x	x	x	x	x	x	x	x
x	x	x	x	x	x	x	x	x	x
x	x	x	x	x	x	x	x	x	x
x	x	x	x	x	x	x	x	x	x
x	x	x	x	x	x	x	x	x	x
x	x	x	x	x	x	x	x	x	x
b	b	b	b	b	b	b	b	b	b
b	b	b	b	b	b	b	b	b	b
b	b	b	b	b	b	b	b	b	b
b	b	b	b	b	b	b	b	b	b
b	b	b	b	b	b	b	b	b	b
x	x	x	x	x	x	x	x	x	x
x	x	x	x	x	x	x	x	x	x
x	x	x	x	x	x	x	x	x	x
x	x	x	x	x	x	x	x	x	x
x	x	x	x	x	x	x	x	x	x
x	x	x	x	x	x	x	x	x	x
x	x	x	x	x	x	x	x	x	x
x	x	x	x	x	x	x	x	x	x
x	x	x	x	x	x	x	x	x	x
x	x	x	x	x	x	x	x	x	x
b	b	b	b	b	b	b	b	b	b
b	b	b	b	b	b	b	b	b	b
b	b	b	b	b	b	b	b	b	b
b	b	b	b	b	b	b	b	b	b
b	b	b	b	b	b	b	b	b	b
x	x	x	x	x	x	x	x	x	x
x	x	x	x	x	x	x	x	x	x
x	x	x	x	x	x	x	x	x	x
x	x	x	x	x	x	x	x	x	x
x	x	x	x	x	x	x	x	x	x
x	x	x	x	x	x	x	x	x	x
x	x	x	x	x	x	x	x	x	x
x	x	x	x	x	x	x	x	x	x
x	x	x	x	x	x	x	x	x	x
x	x	x	x	x	x	x	x	x	x
x	x	x	x	x	x	x	x	x	x
x	x	x	x	x	x	x	x	x	x
b	b	b	b	b	b	b	b	b	b
b	b	b	b	b	b	b	b	b	b
b	b	b	b	b	b	b	b	b	b
b	b	b	b	b	b	b	b	b	b
b	b	b	b	b	b	b	b	b	b
b	b	b	b	b	b	b	b	b	b
b	b	b	b	b	b	b	b	b	b
x	x	b	b	b	x	x	b	b	b
x	x	b	b	b	x	x	b	b	b
x	x	b	b	b	x	x	b	b	b
x	x	b	b	b	x	x	b	b	b
x	x	b	b	b	x	x	b	b	b
x	x	b	b	b	x	x	b	b	b
x	x	b	b	b	x	x	b	b	b
x	x	b	b	b	x	x	b	b	b
x	x	b	b	b	x	x	b	b	b
x	x	b	b	b	x	x	b	b	b
x	x	b	b	b	x	x	b	b	b
x	x	b	b	b	x	x	b	b	b
b	b	b	b	b	b	b	b	b	b
b	b	b	b	b	b	b	b	b	b
b	b	b	b	b	b	b	b	b	b
b	b	b	b	b	b	b	b	b	b
x	x	x	x	x	b	x	x	x	x
x	x	x	x	x	b	x	x	x	x
x	x	x	x	x	b	x	x	x	x
x	x	x	x	x	b	x	x	x	x
x	x	x	x	x	b	x	x	x	x
x	x	x	x	x	b	x	x	x	x
x	x	x	x	x	b	x	x	x	x
x	x	x	x	x	b	x	x	x	x
x	x	x	x	x	b	x	x	x	x
x	x	x	x	b	b	x	x	x	x
x	x	x	x	b	b	x	x	x	x
x	x	x	x	b	b	x	x	x	x
x	x	x	x	b	b	x	x	x	x
x	x	x	x	b	b	x	x	x	x
x	x	x	b	b	b	b	x	x	x
x	x	x	b	b	b	b	x	x	x
x	x	x	b	b	b	b	x	x	x
x	x	x	b	b	b	b	x	x	x
x	x	b	b	b	b	b	b	x	x
x	x	b	b	b	b	b	b	x	x
x	x	b	b	b	b	b	b	x	x
x	x	b	b	b	b	b	b	x	x
b	b	b	b	b	b	b	b	b	b
b	b	b	b	b	b	b	b	b	b
b	b	b	b	b	b	b	b	b	b
b	b	b	b	b	b	b	b	b	b
b	b	b	b	b	b	b	b	b	b
x	x	x	x	x	x	x	x	x	x
x	x	x	x	x	x	x	x	x	x
x	x	x	x	x	x	x	x	x	x
x	x	x	x	x	x	x	x	x	x
x	x	x	x	x	x	x	x	x	x
x	x	x	x	x	x	x	x	x	x
x	x	x	x	x	x	x	x	x	x
x	x	x	x	x	x	x	x	x	x
x	x	x	x	x	x	x	x	x	x
x	x	x	x	x	x	x	x	x	x
x	x	x	x	x	x	x	x	x	x
x	x	x	x	x	x	x	x	x	x
x	x	x	x	x	x	x	x	x	x
x	x	x	x	x	x	x	x	x	x

